NO map_texture/textures/wall_1.xpm
SO map_texture/textures/wall_2.xpm
WE map_texture/textures/wall_3.xpm
EA map_texture/textures/wall_4.xpm

F 120,80,0
C 20,45,0

111111111111111111111111111111111
100000000000000000000000000000001
100000000000000000000000000000001
1000000000000000000N0000000000001
100000000000000000000000000000001
111111111111111111111111111111111